NO ./path_no
SO ./path_so
WE ./path_we
EA ./path_ea

F 220,100,0
C 225,30,0

    1111111
    1S00001
    1011101
11111000001
10000000001
10000011111
1000101
1011101
1000001
1111111